1111111111111111111111111111111111111111111
101110111111111111111111111111111C111111101
1C0010000C0000000000000000C0000C00000000001
10101111111011111101111111111111E1111111101
101010000010001000000000C000000000C0000C001
1010111111101011110101111111111111111111111
1C001000001000100000000C00000000C0000000001
1010111110101010110101111111111111111111111
10101C00000010100000000C000000000C000000001
1011101111101011110101111111111111111111111
100000C0001000100000000000000C0000000C00001
1111111111101011110101111111111111111111111
100C0C000000001000000000000000C0000000C0001
1011111111101111110111111111111111111111111
10C000000010000000000000C000C00C00000000001
1011111110111111101101111111111111111111111
1C00100000000000000000C00000000P00000000001
1010111111101111110111111111111111111111111
1010100000100010000000000000000C00000000001
1010111111101011110101111111111111111111111
100C100000100010000000000000000000000000001
1111111111111111111111111111111111111111111