11111111111111111
1P00C000C000C00E1
10001111001111001
1C00C000C000C00C1
10001111001111001
1C000C00C000C0001
11111111111111111