11111111111111111111111111
100000CCCCCCCCCCCCC0000011
1CCCCC0CCCCCCCCCCCCC000001
1CCCCC00000000000000000011
1CCCCC0CCCCCCCCCCCCC000001
1CCCCC0CCCCCCCCCCCCC000001
1CCCCC0CCCCCCCCCCCCC000001
1CCCCC00000000000000000011
1CCCCC0CCCCCCCCCPCCC000001
1CCCCC0CCCCCCCCCCCCC000001
1CCCCC00000000000000000011
1CCCCC0CCCCCCCCCCCCC000001
1CCCCC0CCCCCCCCCCCCC000001
1CCCCC0CCCCCCCCCCCCC000001
1CCCCC00000000000000000011
1CCCCC0CCCCCCCCCCCCC0000E1
11111111111111111111111111
