111111111111111111111111111111
1E0000000000CCCCCCCCC000000001
1C0C11111C0C000C000000C1111111
1C0CCCCCCC0C000C000000C0CCCCC1
1C0C11111C0C000C111111C0C11111
1C0C00000C0C000C0CCCCCC0C00001
1C0C11111C0C000C0C11111C0C1111
1C0CCCCCCC0C000C0C00000C0CCCC1
1C0000000C0C111C1110000C0C0001
1C1111111C0CCCCCCCCC111C0C1111
1C0C11111C0CCCCCC0C1111C0C1111
1C1111111C0CCCCCC0CCCCCC0C1111
1C0CCCCCC0C00000C000000C0CCCC1
1C0CCCCCC0C11111C111111C0C1111
1C0000P0000CCCCC0000000C0CCCC1
111111111111111111111111111111
