1111111111111111111111
1000000000000000000001
10000C0000E00000000001
1000010000000010000001
1001110000000011110001
1001000P00000000010001
1001111000000111110001
1000001111110000000001
100000000000000C000001
1111111111111111111111
